.........
WWWW.....
.........
.........
..WWWWW..
..W......
..W......
.........
.........